<PROMPT>wide map, many traps, gap between platforms</PROMPT>
<MAP>
--------------------------------------
--------------------------------------
--------------------------------------
--------------------------------------
--------------------------------------
--------------------------------------
--------------------------------------
--------------------------------------
--------------------------------------
--------------------------------------
--------------------------------------
WWWWWWWWWWWWWWWWWWWWWWWWWWWWWWWWWW----
WTTTTTTTTTTTTTTTTTTTTTTTTTTTTT---W----
W--------------------------------W----
W--------------------------------W----
W--------------------------------W----
W-----------------------------T-GW----
W-----------------------------WWWW----
W-----------------------------W-------
W-----------------------------W-------
W-----------------------------W-------
W-----------------------------W-------
W-P-------O-------------------W-------
WWWWTTTWWWWWWWTTTWWWWWWWTTTWWWW-------
---WWWWW-----WWWWW-----WWWWW----------
</MAP>