<PROMPT>tall map, some traps, gap between platforms</PROMPT>
<MAP>
WWWWWWWWWWWWWWWWWWWW------------------
W------------------W------------------
W------------------W------------------
W-------W--W-------W------------------
W-------W--W-------W------------------
W-------WG-W-------W------------------
W-------WWWW-------W------------------
W------------------W------------------
W--W------------W--W------------------
W--WW----------WW--W------------------
W------------------W------------------
W------------------W------------------
W------------------W------------------
W------------------W------------------
W------------------W------------------
W--------O---------W------------------
W-------WWWW-------W------------------
W-------TTTT-------W------------------
W------------------W------------------
W------------------W------------------
W------------------W------------------
W------------------W------------------
WWW--------------WWW------------------
W--------P---------W------------------
WWWWWWWWWWWWWWWWWWWW------------------
</MAP>