<PROMPT>wide map, many traps, platform layout</PROMPT>
<MAP>
--------------------------------------
--------------------------------------
--------------------------------------
--------------------------------------
--------------------------------------
--------------------------------------
--------------------------------------
--------------------------------------
--------------------------------------
WWWWWWWWWWWWWWWWWWWWWWWWWWWWWW--------
W----------------------------W--------
W----------------------------W--------
W----------------------------W--------
W-------------O--------------W--------
W------------WWWW------------W--------
W----------------------------W--------
W----------------------------W--------
W----------------------------W--------
W-----WWWW---------------G---W--------
W----------------------WWWW--W--------
W----------------------------W--------
W----------------------------W--------
W----------------------------W--------
WP----TTTTTTTTTTTTTTTTTTTTTTTW--------
WWWWWWWWWWWWWWWWWWWWWWWWWWWWWW--------
</MAP>