<PROMPT>tall map, few traps, needs jumping</PROMPT>
<MAP>
--------------------------------------
WWWWWWWWWWWWWWWW----------------------
W--------------W----------------------
W--------O-----W----------------------
W-W-W----W-----W----------------------
W-W-WW---W-----W----------------------
W-W-WWW--------W----------------------
W-W-WWWW-------W----------------------
W-W-WWWWW------W----------------------
W-W--WWWWW-----W----------------------
W-W---WWWWW----W----------------------
W-WW-GWWWWWW---W----------------------
W-WWWWWWWWWWW--W----------------------
W--------------W----------------------
W--------------W----------------------
W--------WW---WW----------------------
W--------WW--WWW----------------------
W-----------WWWW----------------------
W----WW----WWWWW----------------------
W----WW---WWWWWW----------------------
W--------WWWWWWW----------------------
W-------WWWWWWWW----------------------
W------WWWWWWWWW----------------------
WTP---WWWWWWWWWW----------------------
WWWWWWWWWWWWWWWW----------------------
</MAP>