<PROMPT>medium map, many traps, needs jumping</PROMPT>
<MAP>
--------------------------------------
--------------------------------------
--------------------------------------
--------------------------------------
--------------------------------------
--------------------------------------
--------------------------------------
--------------------------------------
WWWWWWWWWWWWWWWWWWWWW-----------------
W-------------------W-----------------
WP------------WWWW--W-----------------
WWWW----------W-----W-----------------
WWWWW---------W-----W-----------------
WWWWWW--------W-W---W-----------------
WWWWWWW------WW-W---W-----------------
WWWWWWWW------W-W---W-----------------
WWWWWWWWW-----W-W---W-----------------
WWWWWWWWWW----W-W---W-----------------
WWWWWWWWWWW---W-W---W-----------------
WWWWWWWWWWWWTTW-W---W-----------------
WWWWWWWWWWWWWWW-W-W-W-----------------
WT--------------W---W-----------------
WTO-------------WG--W-----------------
WWWWWWWWWWWWWWWWWWWWW-----------------
WWWWWWWWWWWWWWWWWWWWW-----------------
</MAP>