<PROMPT>tall map, no traps, platform layout</PROMPT>
<MAP>
WWWWWWWWWW----------------------------
W--------W----------------------------
W--------W----------------------------
W---G----W----------------------------
W---WW---W----------------------------
W--------W----------------------------
W--------W----------------------------
WO-------W----------------------------
WWW------W----------------------------
W--------W----------------------------
W--------W----------------------------
W--------W----------------------------
W------WWW----------------------------
W--------W----------------------------
W--------W----------------------------
W--------W----------------------------
W--------W----------------------------
WWW------W----------------------------
W--------W----------------------------
W--------W----------------------------
W--------W----------------------------
W--------W----------------------------
W--------W----------------------------
W---P----W----------------------------
WWWWWWWWWW----------------------------
</MAP>