<PROMPT>small map, no traps, platform layout</PROMPT>
<MAP>
--------------------------------------
--------------------------------------
--------------------------------------
--------------------------------------
--------------------------------------
--------------------------------------
--------------------------------------
--------------------------------------
--------------------------------------
--------------------------------------
--------------------------------------
WWWWWWWWWWWWW-------------------------
W-----------W-------------------------
W-----------W-------------------------
W---------G-W-------------------------
W---------WWW-------------------------
W-----------W-------------------------
W-----------W-------------------------
W-----O-----W-------------------------
W---WWWW----W-------------------------
W-----------W-------------------------
W-----------W-------------------------
W-----------W-------------------------
W-P---------W-------------------------
WWWWWWWWWWWWW-------------------------
</MAP>