<PROMPT>tall map, many traps, needs jumping</PROMPT>
<MAP>
--------------------------------------
--------------------------------------
--------------------------------------
--------------------------------------
--------------------------------------
--------------------------------------
WWW-----WWW---------------------------
WTWW-G-WWTW---------------------------
W-TW-W-WT-W---------------------------
W--T---T--W---------------------------
W---------W---------------------------
W---------W---------------------------
W----O----W---------------------------
W---WWW---W---------------------------
W---------W---------------------------
W---------W---------------------------
WWW-----WWW---------------------------
W-WW---WW-W---------------------------
W--WW-WW--W---------------------------
W---------W---------------------------
W---------W---------------------------
W---------W---------------------------
W---------W---------------------------
WTT--P--TTW---------------------------
WWWWWWWWWWW---------------------------
</MAP>