<PROMPT>tall map, many traps, needs jumping</PROMPT>
<MAP>
WWWWWWWWWWWWWWWWWWWWWWWWWWWWW---------
W---------------------------W---------
W---------------------------W---------
W--WWWWWWWWWWWWWWWWWWWWWWW--W---------
W--------WW--------------W--W---------
W------------------------W-OW---------
WWWW---------------------W--W---------
W--------WW--------------W--W---------
W------WWWWWWWWWWWW---W--W--W---------
W------W-------TTTT---W-WW--W---------
W------W--------------W--W--W---------
W------W--------------W--W--W---------
W---WWWW--------------W--W--W---------
W------W------WWW----WWW-W--W---------
W------W--------------W--W--W---------
WWWW---W--------------W--W--W---------
W------W--WWW---------W--W-WW---------
W------W--------------W--W-TW---------
W----WWW--------------W-WW--W---------
W------W--------------W--W--W---------
WW-----WWW----------WWW--W--W---------
W------WWWW--------WWWW-----W---------
W------WWWWW------WWWWW-----W---------
WTTT-P-WWWWW--G---WWWWW-----W---------
WWWWWWWWWWWWWWWWWWWWWWWWWWWWW---------
</MAP>