<PROMPT>medium map, no traps, needs jumping</PROMPT>
<MAP>
--------------------------------------
--------------------------------------
--------------------------------------
--------------------------------------
--------------------------------------
--------------------------------------
--------------------------------------
--------------------------------------
--------------------------------------
--------------------------------------
WWWWWWWWWWWWWWWWWWWWWWWW--------------
W------WWWWWWWWWWWWWWWWW--------------
WO---------------------W--------------
WWWW-------------------W--------------
WWWWW------------------W--------------
WWWWWW-----------------W--------------
WWWWWWWWWWWWWWWWWWWW---W--------------
WWWWWWWWWWWWWWWWWWWWW--W--------------
WWWWWWWWWWWWWWWWWWWWW--W--------------
W----------------------W--------------
W-------------------WW-W--------------
W-------------------W--W--------------
WP------------------W--W--------------
WWWWWWWWWWWWWWWWWWWWWG-W--------------
WWWWWWWWWWWWWWWWWWWWWWWW--------------
</MAP>