<PROMPT>wide map, many traps, gap between platforms</PROMPT>
<MAP>
--------------------------------------
--------------------------------------
--------------------------------------
--------------------------------------
--------------------------------------
--------------------------------------
--------------------------------------
--------------------------------------
--------------------------------------
--------------------------------------
--------------------------------------
--------------------------------------
--------------------------------------
--------------------------------------
--------------------------------------
--------------------------------------
WWWWWWWWWWWWWWWWWWWWWWWWW-------------
WWWWWWWTTTWWWTTTWWWWWWWWW-------------
W-----------------------W-------------
W------------------TWW--W-------------
W--------------------W--W-------------
W--------------------W--W-------------
W-P-----------------OW-GW-------------
WWWWTTTWWWTTTWWWTTTWWWWWW-------------
WWWWWWWWWWWWWWWWWWWWWWWWW-------------
</MAP>