<PROMPT>tall map, no traps, needs jumping</PROMPT>
<MAP>
--------------------------------------
--------------------------------------
--------------------------------------
--------------------------------------
-------WWWWWWWWWWWWWWWWWWW------------
-------W------W----------W------------
-------W-----------------W------------
-------W-----------------W------------
-------W-----------------W------------
WWWWWWWW---WWWW----------W------------
W----------W--W----------W------------
W----------W--W----------W------------
WP-------O-W--W----------W------------
WWW----WWWWW--W-------WWWW------------
--------------W----------W------------
--------------W----------W------------
--------------W----------W------------
--------------W----------W------------
--------------W----------W------------
--------------WWWW-------W------------
--------------W----------W------------
--------------W----------W------------
--------------W----------W------------
--------------W-G--------W------------
--------------WWW-----WWWW------------
</MAP>