<PROMPT>tall map, many traps, platform layout</PROMPT>
<MAP>
--------------------------------------
WWWWWWWWWWWWWWWW----------------------
W--------------W----------------------
W--------------W----------------------
W--------------W----------------------
W----T---------W----------------------
WW---WWWWWWW---W----------------------
W----W-----W---W----------------------
W----W-----W--WW----------------------
W----W--G--W---W----------------------
W----W--W--W---W----------------------
W----W-----W---W----------------------
W---WW-----W---W----------------------
W----W-----W--WW----------------------
W----W-----W---W----------------------
W----W---------W----------------------
W----W---------W----------------------
W----W---------W----------------------
W----W---WWW--WW----------------------
WW---W----WW---W----------------------
W----W---------W----------------------
W----W----O----W----------------------
W----W---------W----------------------
W----W---TTTT-WW----------------------
WWWWWWWWWWWWWWWW----------------------
</MAP>