<PROMPT>wide map, no traps, gap between platforms</PROMPT>
<MAP>
--------------------------------------
--------------------------------------
--------------------------------------
--------------------------------------
--------------------------------------
--------------------------------------
--------------------------------------
--------------------------------------
--------------------------------------
--------------------------------------
--------------------------------------
--------------------------------------
--------------------------------------
--------------------------------------
--------------------------------------
--------------------------------------
--------------------------------------
--------------------------------------
--------------------------------------
--------------------------------------
WWWWWWWWWWWWWWWWWWWWWWWWWW------------
W------------------------W------------
W------------------------W------------
W-P----------O---------G-W------------
WWW--WWWW--WWWW--WWWW--WWW------------
</MAP>