<PROMPT>medium map, many traps, platform layout</PROMPT>
<MAP>
--------------------------------------
--------------------------------------
--------------------------------------
--------------------------------------
--------------------------------------
--------------------------------------
--------------------------------------
--------------------------------------
--------------------------------------
--------------------------------------
--------------------------------------
--------------------------------------
--------------------------------------
WWWWWWWWWWWWWWWWWWWWWWW---------------
WTTTTTTTTT------------W---------------
W---------------------W---------------
W-------------------G-W---------------
W----------O--------WWW---------------
W--------WWWW---------W---------------
W---------------------W---------------
W---------------------W---------------
W----WWWW-------------W---------------
W---------------------W---------------
WP--------------------W---------------
WWW-------------------W---------------
</MAP>