<PROMPT>wide map, no traps, platform layout</PROMPT>
<MAP>
--------------------------------------
--------------------------------------
--------------------------------------
--------------------------------------
--------------------------------------
--------------------------------------
--------------------------------------
--------------------------------------
--------------------------------------
--------------------------------------
-----WWWWWWWWWWWWWWWWWWWWWW-----------
----W---------------------W-----------
---W----------------------W-----------
--W----------------------GW-----------
-W----------------------WWW-----------
W-------------------------------------
W----------------WWWW-----------------
W-------------------------------------
W------------O------------------------
W----------WWWW-----------------------
W-------------------------------------
W----WWWW-----------------------------
W-------------------------------------
WP------------------------------------
WWWW----------------------------------
</MAP>