<PROMPT>tall map, no traps, platform layout</PROMPT>
<MAP>
--------------------------------------
--------------------------------------
--------------------------------------
--------------------------------------
--------------------------------------
-WWWWWWWWW----------------------------
-W-------W----------------------------
WW-------WW---------------------------
W----G----W---------------------------
W----W----W---------------------------
W---------W---------------------------
W----O----W---------------------------
W---WWW---W---------------------------
W---------W---------------------------
W---------W---------------------------
W--WWWWW--W---------------------------
W---------W---------------------------
W---------W---------------------------
W---------W---------------------------
W---------W---------------------------
WWW-----WWW---------------------------
W---------W---------------------------
W---------W---------------------------
W----P----W---------------------------
WWWWWWWWWWW---------------------------
</MAP>