<PROMPT>wide map, no traps, gap between platforms</PROMPT>
<MAP>
--------------------------------------
--------------------------------------
--------------------------------------
--------------------------------------
--------------------------------------
--------------------------------------
--------------------------------------
--------------------WWWWW-------------
------------------------WW------------
-------------------------WW-----------
--------------------WWWW--WW----------
-----------------------WW--WW---------
------------------------WW--WW--------
--------------O----------WW--WW-------
-------------WWW----------WW--WW------
---------------------------WW--WW-----
----------------------------WW--WW----
---------WWW-----------------WW--WWWWW
------------------------------WW-----W
-------------------------------WW----W
W--------------WWW----W---------WW--GW
WW-------------------WW----------WWWWW
-WW-----------------WW----------------
--WW-------P-------WW-----------------
---WWW---WWWWW---WWW------------------
</MAP>