<PROMPT>medium map, some traps, platform layout</PROMPT>
<MAP>
--------------------------------------
--------------------------------------
--------------------------------------
--------------------------------------
--------------------------------------
--------------------------------------
--------------------------------------
WWWWWWWWWWWWWWWWWWW-------------------
W-----------------W-------------------
W-----------------W-------------------
W-----------------W-------------------
WG--------WWWW----W-------------------
WWWW------WWWW----W-------------------
----------TTTT----W-------------------
------------------W-------------------
------------------W-------------------
------------------W-------------------
---WWWW---O-------W-------------------
---W-----WWW------W-------------------
---W--------------W-------------------
---W--------------W-------------------
---WP------------WW-------------------
---WWWW----------W--------------------
------WTTTTTTTTTTW--------------------
------WWWWWWWWWWWW--------------------
</MAP>