<PROMPT>small map, no traps, platform layout</PROMPT>
<MAP>
--------------------------------------
--------------------------------------
--------------------------------------
--------------------------------------
--------------------------------------
--------------------------------------
--------------------------------------
--------------------------------------
--------------------------------------
--------------------------------------
--------------------------------------
--------------------------------------
WWWWWWWWWWW---------------------------
W----W----W---------------------------
W----W----W---------------------------
W---------W---------------------------
W----O----W---------------------------
W---------W---------------------------
W----W----W---------------------------
W----W----W---------------------------
W----W----W---------------------------
W----W----W---------------------------
W----W----W---------------------------
W-P--W--G-W---------------------------
WWWWWWWWWWW---------------------------
</MAP>