<PROMPT>medium map, many traps, needs jumping</PROMPT>
<MAP>
--------------------------------------
--------------------------------------
--------------------------------------
--------------------------------------
--------------------------------------
WWWWWWWWWWWWWWWW----------------------
W-------WW-TTTTW----------------------
W-------TW-----W----------------------
W--------T-----W----------------------
W--------------W----------------------
W--------------W----------------------
W--O-----------W----------------------
W--WW---T------W----------------------
W-------WT-----W----------------------
W-------WW-----W----------------------
W-------WW-----W----------------------
WW------WW-----W----------------------
WWW-----WW---G-W----------------------
WWWW----WWWWWWWW----------------------
WWWWW----------W----------------------
WWWWWW---------W----------------------
WWWWWWW------P-W----------------------
WWWWWWWWW---WWWW----------------------
WWWWWWWWWTTTWWWW----------------------
WWWWWWWWWWWWWWWW----------------------
</MAP>