<PROMPT>wide map, many traps, gap between platforms</PROMPT>
<MAP>
--------------------------------------
--------------------------------------
--------------------------------------
--------------------------------------
--------------------------------------
--------------------------------------
--------------------------------------
WWWWWWWWWWWWWWWWWWWWWWWWWWWWWWWWWW----
W--------------------------------W----
W--------------------------------W----
W------------------------------O-W----
WG-------------------------------W----
WWW-------WWWTTTWWWTTTWWWTTTTTWWWW----
--W-------WWWWWWWWWWWWWWWWWWWW--------
--WWW-------TTTT--TTTT--TTTTTT--------
--W-----------------------------------
--W-------------------------------W---
--W-------------------------------W---
--W-------------------------------W---
--W-----------------------------P-W---
--W--WWW--TTWWWWTTWWWWTT---W---WWWW---
--W-------WW----WW----WW--W-----------
--WWWWWWWWW--------------WWWWWW-------
--------------------------W-----------
---------------------------W----------
</MAP>