<PROMPT>small map, no traps, platform layout</PROMPT>
<MAP>
--------------------------------------
--------------------------------------
--------------------------------------
--------------------------------------
--------------------------------------
--------------------------------------
--------------------------------------
--------------------------------------
--------------------------------------
--------------------------------------
--------------------------------------
--------------------------------------
WWWWWWWWWWWWWWWWWWWW------------------
W------------------W------------------
W------------------W------------------
W----------------G-W------------------
W---------------WWWW------------------
W------------------W------------------
W---------O--------W------------------
W-------WWWWW------W------------------
W------------------W------------------
W------------------W------------------
W------------------W------------------
W-P----------------W------------------
WWWWWWWWWWWWWWWWWWWW------------------
</MAP>