<PROMPT>wide map, no traps, needs jumping</PROMPT>
<MAP>
--------------------------------------
--------------------------------------
--------------------------------------
--------------------------------------
--------------------------------------
--------------------------------------
--------------------------------------
--------------------------------------
--------------------------------------
--------------------------------------
--------------------------------------
--------------------------------------
--------------------------------------
WWWW----------------------------------
W--WWWWWWWWWWWWWW---------------------
W---------------W---------------------
W-P-----------O-W---------------------
WWWWWWWWWWW--WWWW---------------------
----------W---W-----------------------
----------WW--W-----------------------
----------W---W------------WWWW-------
----------W--WWWWWWWWWWWWWWW--W-------
----------W-------------------W-------
----------WW----------------G-W-------
----------WWWWWWWWWWWWWWWWWWWWW-------
</MAP>