<PROMPT>medium map, no traps, platform layout</PROMPT>
<MAP>
--------------------------------------
--------------------------------------
--------------------------------------
----WWWWWWWWWWWWWWWWWWWWW-------------
----W-------------------W-------------
----W-------------------W-------------
----W-------------------W-------------
----W-----------------G-W-------------
----W-----WWWWWWWWWWWWWWWWWWWWWWWWWWWW
----W-----W--------------------------W
----W-----W--------------------------W
----W-----W--------------------------W
----W-----W--------------------------W
----W-----W--------------------------W
----W-----W-----------O--------------W
----W-----W--------------------------W
----W-----W--------------------------W
----W--------------------------------W
----W--------------------------------W
----WWWWWWWWWWWWWWWWWWWWWWWWWWWWW----W
--------------------------------W----W
WWWWWWWWWWWWWWWWWWWWWWWWWWWWWWWWW----W
W------------------------------------W
WP-----------------------------------W
WWWWWWWWWWWWWWWWWWWWWWWWWWWWWWWWWWWWWW
</MAP>